1111111111111111111111111111111111111111111111111111111111111111
1000000000000000100000000000000000000000000000000000000000000001
1000000000000000100000000000000000000000000000000000000000000001
1000000000000000100000000000000000000000000000000000000000000001
1000000001121000100000000000000000000000000000000000000000000001
1000000000000000100000000000000000000000000000000000000000000001
1011110000000000100000000000000000000000000000000000000000000001
1000000000000000100000000000000000000000000000000000000000000001
1000000000000000100000000000000000000000000000000000000000000001
1000000000000009190000000000000000000000000000000000000000000001
1111111111001111111111111111111111111111111111111111111111111111