0000000000000000111111111111111111111111111111111111111111111111111111
0000000000000000100000000000100000000000000100000000000000000000000001
1111111111111111100000000000100000000000000100000000000000000000000001
1000000000000000100000000000100000000000009100000000000000000000000001
1000000000000000110001111111111000111110001111111000001111100000111111
1000000000000000100000000000000000001000000100000000000000000000000001
1000000001111000100000000000000000001000000100000000000000000000000001
1000000000000000100000000000000000001000000100000000000000000000000001
1011110000000000111111100011111000111111111111111000001111100000111111
1000000000000000100000000000001000000000000100000000000000000000000001
1000000000000000100000000000001000000000000100000000000000000000000001
1000000000000009180000000000001000000000000180000000000000000000000091
1111111111001111111111111111111111111111111111111000001111100000111111
